

WE textures/spaceship/wall_1.xpm
SO textures/spaceship/wall_4.xpm

C 255,255,0
F 0,20,147

NOo textures/spaceship/wall_3.xpm

EA textures/spaceship/wall_2.xpm

 11111
10000011
1000001N1
10000011
 11111
