
WE textures/spaceship/wall_1.xpm
SO textures/spaceship/wall_4.xpm
 
 
C 1,255,0
F 9,20,147
 
NO textures/spaceship/wall_3.xpm
                            
EA textures/spaceship/wall_2.xpm
                              
 111111    1
10     1  1N1
1000001    1
 111111
1