

WE textures/spaceship/wall_1.xpm
SO textures/spaceship/wall_4.xpm


C 55,255,0
F 91,20,147

NO textures/spaceship/wall_3.xpm

EA textures/spaceship/wall_2.xpm

 111111
10    N1
1000001
 111111

 