WE textures/spaceship/wall_1.xpm
F           	-7255,255,255
  EA     textures/spaceship/wall_2.xpm
NO       textures/spaceship/wall_3.xpm

 SO               textures/spaceship/wall_4.xpm
C            1000000,122,122

 111111111111111111111111
1N0000000110000000000001
1011000001110000000000001
100100000000000000000000111111111
1111111110110000001110000000000001
100000000000000001110111111111111
11110111111111011100000010001
11110111111111011101010010001
11000000110101011100000010001
100000000111110011000000100011
1000000000  00000001101010000010001
1000000001111100001101010000010001
1100001111010101111101111000111
111101   1110101 101111010001
11111111 1111111 111111111111




