WE textures/spaceship/wall_1.xpm
EA textures/spaceship/wall_2.xpm
NO textures/spaceship/wall_3.xpm
SO textures/spaceship/wall_4.xpm

F 122,200,0
C 122,122,122

1111111111111111111111111
1000000000110000000000001
1011000001110000000000001
100100000000000000000000111111111
1111111110110000001110000000000001
100000000000000001110111111111111
11110111111111011100000010001
11110111111111011101010010001
11000000110101011100000010001
1000000N0000000011000000100011
1000000000000001101010000010001
1100000111010101111101111000111
11110111 1110101 101111010001
11111111 1111111 111111111111




