WE textures/spaceship/wall_1.xpm
EA textures/spaceship/wall_2.xpm
NO textures/spaceship/wall_3.xpm
SO textures/spaceship/wall_4.xpm


C 55,255,0
F 255,20,147


      111111111111111111
      100000000000000001
      111111111111111101
      110000000000000101
      110000000100000101
      100000000100000101     110
      100000000100000101    1N1
      100000000100011101     11
      100000000100010001
      100000000100010101
      100000000100010101
      101111111110111010
      10011111111011101
      00000000000000
      111111111111111111
