WE textures/spaceship/wall_1.xpm
EA textures/spaceship/wall_2.xpm
NO textures/spaceship/wall_3.xpm
SO textures/spaceship/wall_4.xpm
F 122,200,122
C 122,122,122





1111111
1111111
1001001
1001001
1001001
1000001
1011101
1111111
1000001
1111111
