
WE textures/spaceship/wall_1.xpm
F           100,255,255
  EA     textures/spaceship/wall_2.xpm
NO       textures/spaceship/wall_3.xpm

 SO               textures/spaceship/wall_4.xpm
C            100,122,122

11111111111
0000S00001
1111111111
